25 25
0 0 0 0 0 0 0 0 0 0 0 0 0 0 0 0 0 0 0 0 0 0 0 0 0
0 0 0 0 0 0 0 0 0 0 0 0 0 0 0 0 0 0 0 0 0 0 0 0 0
0 0 0 0 0 0 0 0 0 0 0 0 0 0 0 0 0 0 0 0 0 0 0 0 0
0 0 0 0 0 0 0 0 0 0 0 0 0 0 0 0 0 0 0 0 0 0 0 0 0
0 1 1 1 1 1 1 1 7 7 1 1 1 1 1 1 1 0 0 0 0 0 0 0 0
0 1 1 4 1 1 1 1 16 16 1 1 4 0 1 1 1 0 0 0 0 0 0 0 0
0 1 4 16 16 16 16 16 16 16 16 16 16 16 16 4 1 0 0 0 0 0 0 0 0
0 1 1 16 1 1 1 1 1 1 1 1 16 16 16 1 1 0 0 0 0 0 0 0 0
0 1 1 16 1 17 14 7 14 7 17 1 16 16 16 1 1 0 0 0 0 0 0 0 0
0 1 1 16 1 1 1 1 1 1 1 1 16 16 16 1 1 0 0 0 0 0 0 0 0
0 1 1 16 16 16 16 16 16 16 16 16 16 1 16 1 1 0 0 0 0 0 0 0 0
0 1 1 16 1 1 1 1 1 16 16 1 16 1 16 1 1 0 0 0 0 0 0 0 0
0 1 1 16 1 17 0 17 1 16 16 1 16 1 16 1 1 0 0 0 0 0 0 0 0
0 1 1 16 1 1 1 1 1 16 16 1 16 1 16 1 1 0 0 0 0 0 0 0 0
0 1 4 16 16 16 16 16 16 16 16 1 16 1 16 1 1 0 0 0 0 0 0 0 0
0 1 1 16 1 1 1 1 1 1 1 1 16 1 16 1 1 0 0 0 0 0 0 0 0
0 1 1 16 16 16 16 16 16 16 16 16 16 16 16 1 1 0 0 0 0 0 0 0 0
0 1 1 4 1 1 1 1 1 1 1 1 1 1 1 1 1 0 0 0 0 0 0 0 0
0 1 1 1 1 1 1 1 1 1 1 1 1 1 1 1 1 0 0 0 0 0 0 0 0
0 0 0 0 0 0 0 0 0 0 0 0 0 0 0 0 0 0 0 0 0 0 0 0 0
0 0 0 0 0 0 0 0 0 0 0 0 0 0 0 0 0 0 0 0 0 0 0 0 0
0 0 0 0 0 0 0 0 0 0 0 0 0 0 0 0 0 0 0 0 0 0 0 0 0
0 0 0 0 0 0 0 0 0 0 0 0 0 0 0 0 0 0 0 0 0 0 0 0 0
0 0 0 0 0 0 0 0 0 0 0 0 0 0 0 0 0 0 0 0 0 0 0 0 0
0 0 0 0 0 0 0 0 0 0 0 0 0 0 0 0 0 0 0 0 0 0 0 0 0
672.0 104.0 |
728.0 48.0 384.0 768.0 576.0 480.0 144.0 528.0 576.0 288.0 624.0 288.0 288.0 288.0 144.0 672.0 624.0 336.0 528.0 480.0 624.0 240.0 |
