25 25
0 0 0 0 0 0 0 0 0 0 0 0 0 0 0 0 0 0 0 0 0 0 0 0 0
0 0 0 0 0 0 0 0 0 0 0 0 0 0 0 0 0 0 0 0 0 0 0 0 0
0 0 0 0 0 0 0 0 0 0 0 0 0 0 0 0 0 0 0 0 0 0 0 0 0
0 0 0 0 0 0 0 0 0 0 0 0 0 0 0 0 0 0 0 0 0 0 0 0 0
0 0 0 0 0 0 0 0 0 0 0 0 0 0 0 0 0 0 0 0 0 0 0 0 0
0 0 0 0 0 0 0 0 0 0 0 0 0 0 0 0 0 0 0 0 0 0 0 0 0
0 0 0 0 0 0 0 0 0 0 0 0 0 0 0 0 0 0 0 0 0 0 0 0 0
0 0 0 0 0 0 0 0 0 0 0 0 0 0 0 0 0 0 0 0 0 0 0 0 0
0 0 0 0 0 0 0 0 0 0 0 0 0 0 0 0 0 0 0 0 0 0 0 0 0
0 0 0 0 0 17 17 17 33 34 17 17 0 0 17 17 33 34 17 17 17 0 0 0 0
0 0 0 0 0 17 17 17 35 36 17 17 1 1 17 17 35 36 17 17 17 0 0 0 0
0 0 0 0 0 17 17 1 1 1 1 1 1 1 1 1 1 1 1 17 17 0 0 0 0
0 0 0 0 0 17 17 1 1 1 1 26 26 26 26 1 1 1 1 17 17 0 0 0 0
0 0 0 0 0 17 17 1 1 1 26 1 1 1 1 26 1 1 1 17 17 0 0 0 0
0 0 0 0 0 17 17 1 1 26 1 26 26 26 26 1 26 1 1 17 17 0 0 0 0
0 0 0 0 0 17 17 1 26 1 26 26 1 1 26 26 1 26 1 17 17 0 0 0 0
0 0 0 0 0 17 17 1 26 26 26 1 26 26 1 26 26 26 1 17 17 0 0 0 0
0 0 0 0 0 17 17 1 26 26 1 26 26 26 26 1 26 26 1 17 17 0 0 0 0
0 0 0 0 0 17 17 1 1 26 26 26 1 1 26 26 26 1 1 17 17 0 0 0 0
0 0 0 0 0 17 17 1 1 1 26 1 26 26 1 26 1 1 1 17 17 0 0 0 0
0 0 0 0 0 17 17 1 1 1 1 26 26 26 26 1 1 1 1 17 17 0 0 0 0
0 0 0 0 0 17 17 17 17 17 17 17 33 34 17 17 17 17 17 17 17 0 0 0 0
0 0 0 0 0 17 17 17 17 17 17 17 35 36 17 17 17 17 17 17 17 0 0 0 0
0 0 0 0 0 0 0 0 0 0 0 0 0 0 0 0 0 0 0 0 0 0 0 0 0
0 0 0 0 0 0 0 0 0 0 0 0 0 0 0 0 0 0 0 0 0 0 0 0 0
768.0 56.0 576.0 200.0 816.0 920.0 672.0 824.0 384.0 536.0 432.0 872.0 384.0 776.0 864.0 536.0 |
728.0 48.0 720.0 288.0 |
