25 25
0 0 0 0 0 0 0 0 0 0 0 0 0 0 0 0 0 0 0 0 0 0 0 0 0
0 0 0 0 0 0 0 0 0 0 0 0 0 0 0 0 0 0 0 0 0 0 0 0 0
0 0 0 0 0 0 0 0 0 0 0 0 0 0 0 0 0 0 0 0 0 0 0 0 0
0 0 0 0 0 0 0 0 0 0 0 0 0 0 0 0 0 0 0 0 0 0 0 0 0
0 1 1 1 1 1 1 1 0 0 1 1 1 1 1 1 1 0 0 0 0 0 0 0 0
0 1 1 4 1 1 1 1 0 0 1 1 4 0 1 1 1 0 0 0 0 0 0 0 0
0 1 4 15 15 15 15 15 15 15 15 15 15 15 15 4 1 0 0 0 0 0 0 0 0
0 1 1 15 1 1 1 1 1 1 1 1 15 15 15 1 1 0 0 0 0 0 0 0 0
0 1 1 15 1 15 15 15 15 15 15 1 15 15 15 1 1 0 0 0 0 0 0 0 0
0 1 1 15 1 1 1 1 1 1 1 1 15 15 15 1 1 0 0 0 0 0 0 0 0
0 1 1 15 15 15 15 15 15 15 15 15 15 15 15 1 1 0 0 0 0 0 0 0 0
0 1 1 15 1 1 1 1 1 15 15 1 15 1 15 1 1 0 0 0 0 0 0 0 0
0 1 1 15 1 16 0 16 1 15 15 1 15 1 15 1 1 0 0 0 0 0 0 0 0
0 1 1 15 1 1 1 1 1 15 15 1 15 1 15 1 1 0 0 0 0 0 0 0 0
0 1 4 15 15 15 15 15 15 15 15 1 15 1 15 1 1 0 0 0 0 0 0 0 0
0 1 1 15 1 1 1 1 1 1 1 1 15 1 15 1 1 0 0 0 0 0 0 0 0
0 1 1 15 15 15 15 15 15 15 15 15 15 15 15 1 1 0 0 0 0 0 0 0 0
0 1 1 4 1 1 1 1 1 1 1 1 1 1 1 1 1 0 0 0 0 0 0 0 0
0 1 1 1 1 1 1 1 1 1 1 1 1 1 1 1 1 0 0 0 0 0 0 0 0
0 0 0 0 0 0 0 0 0 0 0 0 0 0 0 0 0 0 0 0 0 0 0 0 0
0 0 0 0 0 0 0 0 0 0 0 0 0 0 0 0 0 0 0 0 0 0 0 0 0
0 0 0 0 0 0 0 0 0 0 0 0 0 0 0 0 0 0 0 0 0 0 0 0 0
0 0 0 0 0 0 0 0 0 0 0 0 0 0 0 0 0 0 0 0 0 0 0 0 0
0 0 0 0 0 0 0 0 0 0 0 0 0 0 0 0 0 0 0 0 0 0 0 0 0
0 0 0 0 0 0 0 0 0 0 0 0 0 0 0 0 0 0 0 0 0 0 0 0 0
672.0 104.0 |
248.0 96.0 384.0 768.0 576.0 480.0 144.0 528.0 576.0 288.0 624.0 288.0 288.0 288.0 384.0 672.0 624.0 240.0 528.0 480.0 336.0 144.0 |
