17 15
5 5 5 5 5 5 5 5 5 5 5 5 5 5 5 5 5
5 0 0 0 0 0 0 0 0 0 0 0 0 0 0 0 5
5 0 0 0 13 0 0 0 13 0 0 0 13 0 0 0 5
5 0 0 0 0 0 0 0 0 0 0 0 0 0 0 0 5
5 0 0 0 0 0 0 0 0 0 0 0 0 0 0 0 5
5 0 3 0 3 0 3 0 0 0 3 0 3 0 3 0 5
5 0 4 0 4 0 4 0 0 0 4 0 4 0 4 0 5
5 0 4 0 4 0 4 0 0 0 4 0 4 0 4 0 5
5 0 4 0 4 0 4 0 0 0 4 0 4 0 4 0 5
5 0 2 0 2 0 2 0 0 0 2 0 2 0 2 0 5
5 0 7 0 7 0 7 0 0 0 7 0 7 0 7 0 5
5 0 8 0 8 0 8 0 0 0 8 0 8 0 8 0 5
5 1 9 1 9 1 9 0 0 0 9 1 9 1 9 1 5
5 0 0 0 0 0 0 0 0 0 0 0 0 0 0 0 5
5 6 6 6 6 6 6 6 6 6 6 6 6 6 6 6 5
|
|
