16 15
1 1 1 1 1 1 0 0 0 1 1 1 1 1 1 1
1 1 4 1 1 1 0 0 0 1 1 4 0 1 1 1
1 4 16 16 16 16 16 16 16 16 16 16 16 16 4 1
1 1 16 1 1 1 1 1 1 1 1 16 1 16 1 1
1 1 16 1 17 14 7 14 7 17 1 16 1 16 1 1
1 1 16 1 1 1 1 1 1 1 1 16 1 16 1 1
1 1 16 1 16 16 16 16 16 16 1 16 1 16 1 1
1 1 16 1 16 1 1 1 16 16 1 16 1 16 1 1
1 4 16 16 16 16 16 1 16 16 1 16 1 16 1 1
1 1 4 1 1 1 16 1 16 16 1 16 1 16 1 1
1 1 1 1 1 1 16 1 16 16 1 16 16 16 1 1
1 1 16 16 16 16 16 1 16 16 1 1 1 16 1 1
1 1 16 16 16 16 16 16 16 16 16 16 16 16 4 1
1 1 1 1 1 1 1 1 16 16 1 1 1 1 1 1
1 1 1 1 1 1 1 1 16 16 1 1 1 1 1 1
384.0 8.0 |
104.0 576.0 96.0 528.0 480.0 576.0 96.0 288.0 528.0 96.0 576.0 96.0 240.0 96.0 144.0 384.0 336.0 576.0 432.0 576.0 576.0 48.0 |
