45 35
0 0 0 0 0 0 0 0 0 0 0 0 0 0 0 0 0 0 0 16 16 16 16 16 16 0 0 0 0 0 0 0 0 0 0 0 0 10 12 12 11 0 0 0 0
0 10 12 12 11 0 4 4 4 0 0 0 0 0 0 0 0 0 0 16 16 16 16 16 16 0 0 0 4 4 4 0 0 10 11 0 0 15 15 15 15 0 0 0 0
0 13 15 15 13 4 4 4 4 4 0 10 12 12 12 12 12 11 0 0 0 0 0 0 0 0 0 4 4 4 4 4 0 15 15 10 12 12 12 12 12 12 11 0 0
10 12 12 12 12 11 2 1 3 0 0 0 13 13 13 13 13 0 14 10 12 12 12 12 11 0 0 0 2 1 3 0 0 15 15 15 15 15 15 15 15 15 15 0 0
0 13 13 13 13 0 16 1 16 0 0 0 13 15 15 13 13 0 0 0 13 13 13 13 0 0 0 14 0 1 0 0 5 15 15 13 13 13 13 13 13 13 13 5 0
5 13 15 6 13 5 16 1 16 0 0 5 13 15 15 6 13 5 0 5 13 15 6 13 5 0 0 0 16 1 16 14 5 15 15 13 13 13 6 6 13 13 13 5 0
5 5 5 7 5 5 9 16 16 14 0 5 5 5 5 7 5 5 9 5 5 5 7 5 5 9 0 0 16 1 16 0 5 5 5 5 5 5 7 7 5 5 5 5 0
16 16 0 7 0 0 8 18 0 0 0 0 0 0 0 7 0 0 8 0 0 0 7 0 0 8 0 0 16 16 16 0 16 16 16 16 16 18 7 7 16 16 16 16 0
16 16 17 17 17 17 17 17 17 17 17 17 17 17 17 17 17 17 17 17 17 17 7 7 0 0 0 0 0 0 0 0 0 14 0 0 0 0 7 7 0 4 4 4 0
14 16 17 17 17 17 17 17 17 17 17 17 17 17 17 17 17 17 17 17 17 17 7 7 0 0 0 0 16 16 16 16 16 0 0 0 0 0 7 7 4 4 4 4 4
16 16 7 7 0 0 0 0 0 0 0 0 4 4 4 0 0 0 0 0 0 0 7 7 0 0 0 0 16 5 5 5 16 0 0 0 14 0 7 7 0 2 1 3 0
16 16 7 7 0 10 12 12 12 11 0 4 4 4 4 4 10 12 12 12 11 0 7 7 0 0 14 0 16 16 16 16 16 0 0 0 0 9 7 7 0 16 1 16 14
16 16 7 7 0 0 13 13 13 0 0 0 2 1 3 0 0 13 13 13 0 0 7 7 18 0 0 0 0 0 0 0 0 0 0 0 0 8 7 7 0 16 1 16 0
16 16 7 7 0 5 15 6 15 5 16 16 0 1 0 0 5 15 6 15 5 0 7 4 17 17 17 17 17 17 17 17 17 17 17 17 17 17 17 17 0 16 16 16 0
16 16 7 7 9 5 5 7 5 5 16 16 0 1 0 9 5 5 7 5 5 0 7 7 17 17 17 17 17 17 17 17 17 17 17 17 17 17 17 17 0 0 0 0 4
16 16 7 7 8 0 0 7 0 0 0 0 14 0 0 8 0 0 7 0 0 0 7 7 14 0 0 7 7 0 0 0 0 0 0 0 0 0 0 0 0 0 0 4 4
16 16 7 7 17 17 17 17 16 17 17 17 17 17 17 17 17 17 17 17 17 17 7 7 0 0 0 7 7 0 0 0 12 12 12 12 12 12 12 12 12 12 4 4 4
16 16 7 17 17 17 17 17 17 17 17 17 17 17 17 17 17 17 17 17 17 17 7 7 0 0 14 7 7 0 0 0 13 13 13 13 13 13 13 13 13 13 0 2 1
0 0 0 0 0 0 0 0 0 0 0 0 0 0 0 0 0 0 0 0 0 0 7 7 0 0 0 7 7 0 14 0 13 15 15 13 15 15 13 15 15 13 0 0 1
0 0 10 12 12 12 12 12 12 12 12 12 12 12 12 12 12 12 12 11 0 0 7 7 4 4 4 7 7 0 0 0 13 15 15 13 13 13 13 15 15 13 0 14 1
0 0 0 13 15 15 13 15 15 13 15 15 13 15 15 13 15 15 13 0 0 0 7 7 2 1 3 7 7 0 16 5 13 13 13 13 6 6 13 13 13 13 5 16 1
0 14 0 13 13 13 13 13 13 13 13 13 13 13 13 13 13 13 13 0 0 0 7 7 16 1 16 7 7 0 16 5 5 5 5 5 7 7 5 5 5 5 5 16 1
0 0 10 12 12 12 12 12 12 12 12 12 12 12 12 12 12 12 12 11 0 0 7 7 16 16 16 7 7 0 0 0 0 0 0 18 7 7 9 0 0 0 0 16 16
0 0 0 13 15 15 13 15 15 13 15 15 13 15 15 13 15 15 13 0 0 0 7 17 17 17 17 17 17 17 17 17 17 17 17 17 7 7 8 0 0 0 0 0 0
0 16 5 13 13 6 13 13 6 13 13 6 13 13 6 13 13 6 13 5 16 0 7 7 17 17 17 17 17 17 17 17 17 17 17 17 7 7 0 0 0 14 0 0 0
0 16 5 5 5 7 5 5 7 5 5 7 5 5 7 5 5 7 5 5 9 0 7 7 0 0 0 0 0 0 0 0 0 0 0 0 0 0 0 0 0 0 0 0 0
0 16 16 16 18 7 16 18 7 16 18 7 16 18 7 16 18 7 16 16 8 0 7 7 0 0 10 12 12 12 11 10 12 12 12 11 10 12 12 12 11 0 0 0 0
0 17 17 17 17 17 17 17 17 17 17 17 17 17 17 17 17 17 17 17 17 17 7 7 0 16 16 13 13 13 16 16 13 13 13 16 16 13 13 13 16 16 0 14 0
0 17 17 17 17 17 17 17 17 17 17 17 17 17 17 17 17 17 17 17 17 17 7 7 0 16 5 13 6 13 5 5 13 6 13 5 5 13 6 13 5 16 0 0 0
0 0 0 0 0 0 0 0 0 0 0 0 0 0 0 0 0 0 0 0 0 0 7 7 0 9 5 5 7 5 5 5 5 7 5 5 5 5 7 5 5 16 0 0 0
0 0 4 4 4 0 0 0 0 4 4 4 0 0 0 0 4 4 4 0 0 0 7 7 0 8 16 16 7 16 16 16 16 7 16 16 16 16 7 16 16 16 0 16 16
0 4 4 4 4 4 0 0 4 4 4 4 4 0 0 4 4 4 4 4 0 0 7 7 17 17 17 17 17 17 17 17 17 17 17 17 17 17 17 17 17 17 0 16 5
14 0 2 1 3 0 0 0 0 2 1 3 0 0 14 0 2 1 3 0 0 0 7 7 17 17 17 17 17 17 17 17 17 17 17 17 17 17 17 17 17 17 0 16 5
0 16 16 1 16 16 16 16 16 16 1 16 16 16 16 16 16 1 16 16 0 0 0 0 0 0 0 0 0 0 0 0 0 0 0 0 0 0 0 0 0 0 0 16 5
0 16 16 16 16 16 16 16 16 16 16 16 16 16 16 16 16 16 16 16 0 0 0 0 0 0 0 0 0 0 0 0 0 0 0 0 0 0 0 0 0 0 0 16 16
1344.0 576.0 1680.0 1104.0 1728.0 384.0 480.0 720.0 960.0 336.0 96.0 336.0 1728.0 1488.0 240.0 1296.0 |
|
