45 35
0 0 0 0 0 0 0 0 0 0 0 0 0 0 0 0 0 0 0 15 15 15 15 15 15 0 0 0 0 0 0 0 0 9 10 0 0 9 11 11 10 0 0 0 0
0 9 11 11 10 0 4 4 4 0 0 0 9 11 11 11 10 0 0 15 15 15 15 15 15 0 0 0 4 4 4 0 9 11 11 10 0 14 14 14 14 0 0 0 0
0 0 14 14 0 4 4 4 4 4 0 9 11 11 11 11 11 10 0 0 9 11 11 10 0 0 0 4 4 4 4 4 0 14 14 9 11 11 11 11 11 11 10 0 0
9 11 11 11 11 10 2 1 3 0 0 0 12 12 12 12 12 0 13 9 11 11 11 11 10 0 0 0 2 1 3 0 0 14 14 14 14 14 14 14 14 14 14 0 0
0 12 12 12 12 0 15 1 15 0 0 0 12 14 14 12 12 0 0 0 12 12 12 12 0 0 0 13 0 1 0 0 4 14 14 12 12 12 12 12 12 12 12 4 0
4 12 14 5 12 4 15 1 15 0 0 4 12 14 14 5 12 4 0 4 12 14 5 12 4 0 0 0 15 1 15 13 4 14 14 12 12 12 5 5 12 12 12 4 0
4 4 4 6 4 4 8 15 15 13 0 4 4 4 4 6 4 4 8 4 4 4 6 4 4 8 0 0 15 1 15 0 4 4 4 4 4 4 6 6 4 4 4 4 0
15 15 0 6 0 0 7 17 0 0 0 0 0 0 0 16 0 0 7 0 0 0 6 0 0 7 0 0 15 15 15 0 15 15 15 15 15 17 6 6 15 15 15 15 0
15 15 6 16 16 16 16 16 16 16 16 16 16 16 16 16 16 16 16 16 16 16 6 6 0 0 0 0 0 0 0 0 0 13 0 0 0 0 6 6 0 4 4 4 0
13 15 6 16 16 16 16 16 16 16 16 16 16 16 16 16 16 16 16 16 16 16 6 6 0 0 0 0 15 15 15 15 15 0 0 0 0 0 6 6 4 4 4 4 4
15 15 6 6 0 0 0 0 0 0 0 0 4 4 4 0 0 0 0 0 0 0 6 6 0 0 0 0 15 4 4 4 15 0 0 0 13 0 6 6 0 2 1 3 0
15 15 6 6 0 9 11 11 11 10 0 4 4 4 4 4 9 11 11 11 10 0 6 6 0 0 13 0 15 15 15 15 15 0 0 0 0 8 6 6 0 15 1 15 13
15 15 6 6 0 0 12 12 12 0 0 0 2 1 3 8 0 12 12 12 0 0 6 6 17 0 0 0 0 0 0 0 0 0 0 0 0 7 6 6 0 15 1 15 0
15 15 6 6 0 4 14 5 14 4 15 15 0 1 0 15 4 14 5 14 4 0 6 4 16 16 16 16 16 16 16 16 16 16 16 16 16 16 16 16 0 15 15 15 0
15 15 6 6 8 4 4 6 4 4 15 15 0 1 0 8 4 4 6 4 4 0 6 6 16 16 16 16 16 16 16 16 16 16 16 16 16 16 16 16 0 0 0 0 4
15 15 6 6 7 0 0 6 0 0 0 0 13 0 0 7 0 0 6 0 0 0 6 6 13 0 0 6 6 0 0 0 0 0 0 0 0 0 0 0 0 0 0 4 4
15 15 6 6 16 16 16 16 16 16 16 16 16 16 16 16 16 16 16 16 16 16 6 6 0 0 0 6 6 0 0 0 11 11 11 11 11 11 11 11 11 11 4 4 4
15 15 6 6 16 16 16 16 16 16 16 16 16 16 16 16 16 16 16 16 16 16 6 6 0 0 13 6 6 0 0 0 12 12 12 12 12 12 12 12 12 12 0 2 1
0 0 0 0 0 0 0 0 0 0 0 0 0 0 0 0 0 0 0 0 0 0 6 6 0 0 0 6 6 0 13 0 12 14 14 12 14 14 12 14 14 12 0 0 1
0 0 9 11 11 11 11 11 11 11 11 11 11 11 11 11 11 11 11 10 0 0 6 6 4 4 4 6 6 0 0 0 12 14 14 12 12 12 12 14 14 12 0 13 1
0 0 0 12 14 14 12 14 14 12 14 14 12 14 14 12 14 14 12 0 0 0 6 6 2 1 3 6 6 0 15 4 12 12 12 12 5 5 12 12 12 12 4 15 1
0 13 0 12 12 12 12 12 12 12 12 12 12 12 12 12 12 12 12 0 0 0 6 6 15 1 15 6 6 0 15 4 4 4 4 4 6 6 4 4 4 4 4 15 1
0 0 9 11 11 11 11 11 11 11 11 11 11 11 11 11 11 11 11 10 0 0 6 6 15 15 15 6 6 0 0 0 0 0 0 17 6 6 8 0 0 0 0 15 15
0 0 0 12 14 14 12 14 14 12 14 14 12 14 14 12 14 14 12 0 0 0 6 6 16 16 16 16 16 16 16 16 16 16 16 16 6 6 7 0 0 0 0 0 0
0 15 4 12 12 5 12 12 5 12 12 5 12 12 5 12 12 5 12 4 15 0 6 6 16 16 16 16 16 16 16 16 16 16 16 16 6 6 0 0 0 13 0 0 0
0 15 4 4 4 6 4 4 6 4 4 6 4 4 6 4 4 6 4 4 8 0 6 6 0 0 0 0 0 0 0 0 0 0 0 0 0 0 0 0 0 0 0 0 0
0 15 15 15 17 6 15 17 6 15 17 6 15 17 6 15 17 6 15 15 7 0 6 6 0 0 9 11 11 11 10 9 11 11 11 10 9 11 11 11 10 0 0 0 0
0 16 16 16 16 16 16 16 16 16 16 16 16 16 16 16 16 16 16 16 16 16 6 6 0 15 15 12 12 12 15 15 12 12 12 15 15 12 12 12 15 15 0 13 0
0 16 16 16 16 16 16 16 16 16 16 16 16 16 16 16 16 16 16 16 16 16 6 6 0 15 4 12 5 12 4 4 12 5 12 4 4 12 5 12 4 15 0 0 0
0 0 0 0 0 0 0 0 0 0 0 0 0 0 0 0 0 0 0 0 0 0 6 6 0 8 4 4 6 4 4 4 4 6 4 4 4 4 6 4 4 15 0 0 0
0 0 4 4 4 0 0 0 0 4 4 4 0 0 0 0 4 4 4 0 0 0 6 6 0 7 15 15 6 15 15 15 15 6 15 15 15 15 6 15 15 15 0 15 15
0 4 4 4 4 4 0 0 4 4 4 4 4 0 0 4 4 4 4 4 0 0 6 6 16 16 16 16 16 16 16 16 16 16 16 16 16 16 16 16 16 16 0 15 4
13 0 2 1 3 0 0 0 0 2 1 3 0 0 13 0 2 1 3 0 0 0 6 6 16 16 16 16 16 16 16 16 16 16 16 16 16 16 16 16 16 16 0 15 4
0 15 15 1 15 15 15 15 15 15 1 15 15 15 15 15 15 1 15 15 0 0 0 0 0 0 0 0 0 0 0 0 0 0 0 0 0 0 0 0 0 0 0 15 4
0 15 15 15 15 15 15 15 15 15 15 15 15 15 15 15 15 15 15 15 0 0 0 0 0 0 0 0 0 0 0 0 0 0 0 0 0 0 0 0 0 0 0 15 4
1200.0 624.0 1680.0 1104.0 1728.0 384.0 384.0 720.0 672.0 336.0 96.0 336.0 1824.0 1488.0 432.0 1296.0 |
|
