17 12
7 5 5 5 5 5 5 5 5 5 5 5 5 5 5 5 7
8 5 5 5 5 5 5 5 5 5 5 5 5 5 5 5 8
8 5 5 5 5 5 5 5 5 5 5 5 5 5 5 5 8
8 5 5 5 5 5 5 5 5 5 5 5 5 5 5 5 8
8 5 5 5 5 5 5 5 5 5 5 5 5 5 5 5 8
8 5 5 5 5 5 5 5 5 5 5 5 5 5 5 5 8
8 5 5 5 5 5 5 5 5 5 5 5 5 5 5 5 8
8 5 5 5 5 5 5 5 5 5 5 5 5 5 5 5 8
8 5 5 5 5 5 5 5 5 5 5 5 5 5 5 5 8
8 5 5 5 5 5 5 5 5 5 5 5 5 5 5 5 8
8 5 5 5 5 5 5 5 5 5 5 5 5 5 5 5 8
9 5 5 5 5 5 5 5 5 5 5 5 5 5 5 5 9
|
|
