16 15
1 1 1 1 1 1 0 0 1 1 1 1 1 1 1 1
1 1 4 1 1 1 0 0 1 1 1 4 1 1 1 1
1 4 16 16 16 16 16 16 16 16 16 16 16 16 4 1
1 1 16 1 1 1 1 1 1 1 1 16 1 16 1 1
1 1 16 1 17 14 17 14 17 14 1 16 1 16 1 1
1 1 16 1 1 1 1 1 1 1 1 16 1 16 1 1
1 1 16 1 16 16 16 16 16 16 1 16 1 16 1 1
1 1 16 1 16 1 1 1 16 16 1 16 1 16 1 1
1 4 16 16 16 16 16 1 16 16 1 16 1 16 1 1
1 1 4 1 1 1 16 1 16 16 1 16 1 1 1 1
1 1 1 1 1 1 16 1 16 16 1 16 16 16 1 1
1 1 16 16 16 16 16 1 16 16 1 1 1 16 1 1
1 1 16 16 16 16 16 16 16 16 16 16 16 16 4 1
1 1 1 1 1 1 1 1 16 16 1 1 1 1 1 1
1 1 1 1 1 1 1 1 16 16 1 1 1 1 1 1
|
152.0 384.0 192.0 96.0 576.0 96.0 528.0 96.0 480.0 576.0 96.0 528.0 96.0 576.0 96.0 240.0 624.0 384.0 |
