16 15
1 1 1 1 1 1 21 21 1 1 1 1 1 1 1 1
1 1 4 1 1 1 21 21 1 1 1 4 1 1 1 1
1 4 21 21 21 21 21 21 21 21 21 21 21 21 4 1
1 1 21 1 1 1 1 1 1 1 1 21 1 21 1 1
1 1 21 1 22 22 22 22 22 22 1 21 1 21 1 1
1 1 21 1 1 1 1 1 1 1 1 21 1 21 1 1
1 1 21 1 21 21 21 21 21 21 1 21 1 21 1 1
1 1 21 1 21 1 1 1 21 21 1 21 1 21 1 1
1 4 21 21 21 21 21 1 21 21 1 21 1 21 1 1
1 1 4 1 1 1 21 1 21 21 1 21 1 1 1 1
1 1 1 1 1 1 21 1 21 21 1 21 21 21 1 1
1 1 21 21 21 21 21 1 21 21 1 1 1 21 1 1
1 1 21 21 21 21 21 21 21 21 21 21 21 21 4 1
1 1 1 1 1 1 1 1 21 21 1 1 1 1 1 1
1 1 1 1 1 1 1 1 21 21 1 1 1 1 1 1
|
152.0 384.0 192.0 96.0 576.0 96.0 528.0 96.0 528.0 240.0 96.0 528.0 96.0 576.0 96.0 240.0 624.0 384.0 |
