17 12
1 1 1 1 1 1 1 1 1 1 1 1 1 1 1 1 1
1 7 7 7 7 7 7 7 7 7 7 7 7 7 7 7 1
1 7 7 7 7 7 7 7 7 7 7 7 7 7 7 7 1
1 7 7 26 7 7 26 7 7 7 7 26 7 7 26 7 1
1 7 7 26 7 7 26 7 7 7 7 26 7 7 26 7 1
1 7 7 26 7 7 26 7 7 7 7 26 7 7 26 7 1
1 7 7 26 7 7 26 7 7 7 7 26 7 7 26 7 1
1 7 7 26 7 7 26 7 7 7 7 26 7 7 26 7 1
1 7 7 26 7 7 26 7 7 7 7 26 7 7 26 7 1
1 7 7 7 7 7 7 7 7 7 7 7 7 7 7 7 1
1 7 7 7 7 7 7 7 7 7 7 7 7 7 7 7 1
1 1 1 1 1 1 1 1 28 29 1 1 1 1 1 1 1
|
|
