17 12
45 45 45 45 45 45 45 45 45 45 45 45 45 45 45 45 45
45 43 43 43 43 43 43 43 43 43 43 43 43 43 43 43 45
45 43 43 43 43 43 43 43 43 43 43 43 43 43 43 43 45
45 43 43 26 43 43 26 43 43 43 43 26 43 43 26 43 45
45 43 43 26 43 43 26 43 43 43 43 26 43 43 26 43 45
45 43 43 26 43 43 26 43 43 43 43 26 43 43 26 43 45
45 43 43 26 43 43 26 43 43 43 43 26 43 43 26 43 45
45 43 43 26 43 43 26 43 43 43 43 26 43 43 26 43 45
45 43 43 26 43 43 26 43 43 43 43 26 43 43 26 43 45
45 43 43 43 43 43 43 43 43 43 43 43 43 43 43 43 45
45 43 43 43 43 43 43 43 43 43 43 43 43 43 43 43 45
45 45 45 45 45 45 45 45 28 29 45 45 45 45 45 45 45
|
|
