40 50
7 7 7 7 7 7 7 7 7 7 7 7 7 7 7 7 7 7 7 7 7 7 7 7 7 7 7 7 7 7 7 7 7 7 7 7 7 1 7 7
7 7 7 7 7 7 7 7 7 7 7 7 7 7 7 7 7 7 7 7 7 7 7 7 7 7 7 7 7 7 7 7 7 7 7 7 7 1 7 7
7 1 1 1 1 1 7 7 1 1 1 1 1 1 1 1 1 1 1 1 1 1 1 1 1 1 1 1 1 1 1 1 1 1 1 1 7 1 7 7
7 7 7 7 7 1 7 7 1 7 7 7 7 7 7 7 7 7 7 7 7 7 7 7 7 7 7 7 1 7 7 1 1 1 1 1 7 1 7 7
7 7 1 7 7 1 7 7 1 7 7 7 7 7 7 7 7 7 7 7 7 7 7 7 7 7 7 7 1 7 7 1 7 7 7 7 7 1 7 7
7 7 1 1 1 1 7 7 1 7 7 1 1 1 1 1 1 1 1 1 1 1 1 1 1 1 7 7 1 7 7 1 7 7 7 7 7 1 7 7
7 7 7 7 7 1 7 7 1 7 7 7 7 7 7 7 7 7 7 7 7 7 7 7 7 1 7 7 1 7 7 1 1 1 1 1 7 1 7 7
7 7 7 7 7 1 7 7 1 7 7 7 7 7 7 7 7 7 7 7 7 7 7 7 7 1 7 7 1 7 7 7 7 7 7 7 7 1 7 7
7 7 1 7 7 1 7 7 1 7 7 1 1 1 1 1 1 1 1 1 1 1 1 7 7 1 7 7 1 7 7 7 7 7 7 7 7 1 7 7
7 7 1 7 7 1 7 7 1 7 7 7 7 1 7 7 7 7 7 7 7 7 1 7 7 1 7 7 1 7 7 1 1 1 1 1 1 1 7 7
7 7 1 7 7 1 7 7 1 7 7 7 7 1 7 7 7 7 7 7 7 7 1 7 7 1 7 7 1 7 7 5 7 7 7 7 7 7 7 7
1 1 1 7 7 1 7 7 1 7 7 7 7 1 7 7 1 7 7 1 7 7 1 7 7 1 7 7 1 7 7 7 7 7 7 7 7 7 7 7
7 7 1 7 7 1 7 7 1 7 7 7 7 7 7 7 1 7 7 1 1 1 1 1 1 1 7 7 1 1 1 1 1 1 1 7 7 1 7 7
7 7 1 7 7 1 7 7 1 7 7 7 7 7 7 7 1 7 7 1 7 7 7 7 7 7 7 7 1 7 7 7 7 7 1 7 7 1 7 7
7 7 1 7 7 1 7 7 1 7 7 7 7 1 1 1 1 7 7 1 7 7 7 7 7 7 7 7 1 7 7 7 7 7 1 7 7 1 7 7
7 7 1 7 7 1 7 7 1 7 7 1 1 1 7 7 1 7 7 1 7 7 1 1 1 1 7 7 1 7 7 1 7 7 1 7 7 1 7 7
7 7 1 7 7 1 1 1 1 7 7 1 7 7 7 7 1 7 7 1 7 7 1 7 7 1 7 7 1 7 7 1 7 7 1 7 7 1 7 7
7 7 7 7 7 7 7 7 1 7 7 1 7 7 7 7 1 7 7 1 7 7 1 7 7 1 7 7 1 7 7 1 7 7 1 1 1 1 7 7
7 7 7 7 7 7 7 7 1 7 7 1 7 7 7 7 1 1 1 1 7 7 1 7 7 1 7 7 1 7 7 1 7 7 7 7 7 7 7 7
1 1 1 1 1 1 7 7 1 7 7 1 7 7 7 7 1 7 7 1 7 7 1 7 7 1 7 7 1 7 7 1 7 7 7 7 7 7 7 7
7 7 7 7 7 7 7 7 1 7 7 1 7 7 7 7 1 7 7 1 7 7 1 7 7 1 7 7 1 7 7 1 7 7 7 7 7 7 7 7
7 7 7 7 7 7 7 7 1 7 7 1 7 7 7 7 7 7 7 1 7 7 1 7 7 1 7 7 1 7 7 1 1 1 1 1 1 1 7 7
1 1 1 1 1 1 7 7 1 7 7 7 7 7 7 7 7 7 7 1 7 7 1 7 7 1 7 7 1 7 7 1 7 7 1 7 7 7 7 7
7 7 7 7 7 7 7 7 1 1 1 1 1 1 1 1 1 7 7 1 7 7 1 7 7 1 7 7 1 7 7 1 7 7 1 7 7 1 7 7
7 7 7 7 7 7 7 7 7 7 1 7 7 7 7 7 1 7 7 7 7 7 1 7 7 1 7 7 1 7 7 1 7 7 1 7 7 1 7 7
7 7 1 7 7 1 7 7 7 7 1 7 7 7 7 7 1 1 1 1 1 1 1 7 7 1 7 7 1 7 7 1 7 7 1 7 7 1 7 7
7 7 1 1 1 1 1 1 7 7 1 7 7 1 7 7 7 7 7 7 7 7 7 7 7 7 7 7 7 7 7 7 7 7 1 7 7 1 7 7
7 7 7 7 7 1 7 7 7 7 1 7 7 1 7 7 7 7 7 7 7 7 7 7 7 7 7 7 7 7 7 7 7 7 1 7 7 1 7 7
7 7 7 7 7 1 7 7 7 7 1 7 7 1 1 1 1 1 1 1 1 1 1 1 1 1 1 1 1 1 1 1 1 1 1 7 7 1 7 7
1 1 1 7 7 1 1 1 7 7 1 7 7 1 7 7 1 7 7 7 7 7 7 7 7 7 7 7 7 7 7 7 7 7 1 7 7 1 7 7
7 7 7 7 7 1 7 7 7 7 1 7 7 1 7 7 1 7 7 7 7 7 7 7 7 7 7 7 7 7 7 7 7 7 1 7 7 1 7 7
7 7 7 7 7 1 7 7 7 7 1 7 7 1 7 7 7 7 7 1 1 1 1 1 1 1 1 1 1 1 1 1 7 7 1 7 7 1 7 7
1 1 1 7 7 1 1 1 1 1 1 7 7 1 7 7 7 7 7 7 7 7 7 7 7 7 7 7 7 7 7 1 7 7 7 7 7 1 7 7
7 7 1 7 7 1 7 7 7 7 1 7 7 1 7 7 7 7 7 7 7 7 7 7 7 7 7 7 7 7 7 1 7 7 7 7 7 1 7 7
7 7 1 7 7 1 7 7 7 7 1 7 7 1 1 1 1 1 1 1 1 1 1 1 1 1 1 1 1 7 7 1 1 1 1 1 1 1 7 7
7 7 1 7 7 7 7 7 7 7 1 7 7 7 7 7 7 7 7 7 7 7 7 7 7 7 7 7 1 7 7 1 7 7 7 7 7 7 7 7
7 7 7 7 7 7 7 7 27 7 1 7 7 7 7 7 7 7 7 7 7 7 7 7 7 7 7 7 1 7 7 1 7 7 7 7 7 7 7 7
1 1 1 1 1 1 1 1 1 1 1 1 1 1 1 1 1 1 1 1 1 1 1 1 1 1 0 0 1 1 1 1 1 1 1 1 1 1 1 1
1 1 1 1 1 1 1 1 1 1 1 0 0 0 0 0 0 0 0 0 0 0 0 0 0 0 0 0 1 1 1 1 1 1 1 1 1 1 1 1
1 1 1 1 1 1 1 1 1 1 1 0 0 0 0 0 0 0 0 0 0 0 0 0 0 0 0 0 1 1 1 1 1 1 1 1 1 1 1 1
1 1 1 1 1 1 1 1 1 1 1 0 0 26 26 0 0 0 0 0 0 0 0 0 0 0 0 0 1 1 1 1 1 1 1 1 1 1 1 1
1 1 1 1 1 1 1 1 1 1 1 0 0 26 26 0 0 0 0 0 0 0 0 0 0 0 0 0 1 1 1 1 1 1 1 1 1 1 1 1
1 1 1 1 1 1 1 1 1 1 1 0 0 26 26 0 0 0 0 0 0 0 0 0 0 0 0 0 1 1 1 1 1 1 1 1 1 1 1 1
1 1 1 1 1 1 1 1 1 1 1 0 0 26 26 0 0 0 0 0 0 0 0 0 0 0 0 0 1 1 1 1 1 1 1 1 1 1 1 1
1 1 1 1 1 1 1 1 1 1 1 0 0 26 26 0 0 0 0 0 0 0 0 0 0 0 0 0 1 1 1 1 1 1 1 1 1 1 1 1
1 1 1 1 1 1 1 1 1 1 1 0 0 26 26 0 0 0 0 0 0 0 0 0 0 0 0 0 1 1 1 1 1 1 1 1 1 1 1 1
1 1 1 1 1 1 1 1 1 1 1 0 0 26 26 0 0 0 0 0 0 0 0 0 0 0 0 0 1 1 1 1 1 1 1 1 1 1 1 1
1 1 1 1 1 1 1 1 1 1 1 0 0 0 0 0 0 0 0 0 0 0 0 0 0 0 0 0 1 1 1 1 1 1 1 1 1 1 1 1
1 1 1 1 1 1 1 1 1 1 1 0 0 0 0 0 0 0 0 0 0 0 0 0 0 0 0 0 1 1 1 1 1 1 1 1 1 1 1 1
1 1 1 1 1 1 1 1 1 1 1 1 1 1 1 1 1 1 1 28 29 1 1 1 1 1 1 1 1 1 1 1 1 1 1 1 1 1 1 1
|
|
