17 12
45 45 45 45 45 45 45 45 45 45 45 45 45 45 45 45 45
45 43 43 43 43 43 43 43 43 43 43 43 43 43 43 43 45
45 43 43 43 43 43 43 43 43 43 43 43 43 43 43 43 45
45 43 43 26 43 43 26 43 43 43 43 26 43 43 26 43 45
45 43 43 26 43 43 26 43 43 43 43 26 43 43 26 43 45
45 43 43 26 43 43 26 43 43 43 43 26 43 43 26 43 45
45 43 43 26 43 43 26 43 43 43 43 26 43 43 26 43 45
45 43 43 26 43 43 26 43 43 43 43 26 43 43 26 43 45
45 43 43 26 43 43 26 43 43 43 43 26 43 43 26 43 45
45 43 43 43 43 43 43 43 43 43 43 43 43 43 43 43 45
45 43 43 43 43 43 43 43 43 43 43 43 43 43 43 43 45
45 45 45 45 45 45 45 45 28 29 45 45 45 45 45 45 45
384.0 48.0 96.0 192.0 192.0 288.0 480.0 336.0 624.0 288.0 |
|
