40 50
0 0 0 0 0 0 0 0 0 0 0 0 0 0 0 0 0 0 0 0 0 0 0 0 0 0 0 0 0 0 0 0 0 0 0 0 0 26 0 0
0 0 0 0 0 0 0 0 0 0 0 0 0 0 0 0 0 0 0 0 0 0 0 0 0 0 0 0 0 0 0 0 0 0 0 0 0 26 0 0
0 26 26 26 26 26 0 0 26 26 26 26 26 26 26 26 26 26 26 26 26 26 26 26 26 26 26 26 26 26 26 26 26 26 26 26 0 26 0 0
0 0 0 0 0 26 0 0 26 0 0 0 0 0 0 0 0 0 0 0 0 0 0 0 0 0 0 0 26 0 0 26 0 0 0 0 0 26 0 0
0 0 26 0 0 26 0 0 26 0 0 0 0 0 0 0 0 0 0 0 0 0 0 0 0 0 0 0 26 0 0 26 0 0 0 0 0 26 0 0
0 0 26 26 26 26 0 0 26 0 0 26 26 26 26 26 26 26 26 26 26 26 26 26 26 26 0 0 26 0 0 26 0 0 0 0 0 26 0 0
0 0 0 0 0 26 0 0 26 0 0 0 0 0 0 0 0 0 0 0 0 0 0 0 0 26 0 0 26 0 0 26 26 26 26 26 0 26 0 0
0 0 0 0 0 26 0 0 26 0 0 0 0 0 0 0 0 0 0 0 0 0 0 0 0 26 0 0 26 0 0 0 0 0 0 0 0 26 0 0
0 0 26 0 0 26 0 0 26 0 0 26 26 26 26 26 26 26 26 26 26 26 26 0 0 26 0 0 26 0 0 0 0 0 0 0 0 26 0 0
0 0 26 0 0 26 0 0 26 0 0 0 0 26 0 0 0 0 0 0 0 0 26 0 0 26 0 0 26 0 0 26 26 26 26 26 26 26 0 0
0 0 26 0 0 26 0 0 26 0 0 0 0 26 0 0 0 0 0 0 0 0 26 0 0 26 0 0 26 0 0 0 0 0 0 0 0 0 0 0
26 26 26 0 0 26 0 0 26 0 0 0 0 26 0 0 26 0 0 26 0 0 26 0 0 26 0 0 26 0 0 0 0 0 0 0 0 0 0 0
0 0 26 0 0 26 0 0 26 0 0 0 0 0 0 0 26 0 0 26 26 26 26 26 26 26 0 0 26 26 26 26 26 26 26 0 0 26 0 0
0 0 26 0 0 26 0 0 26 0 0 0 0 0 0 0 26 0 0 26 0 0 0 0 0 0 0 0 26 0 0 0 0 0 26 0 0 26 0 0
0 0 26 0 0 26 0 0 26 0 0 0 0 26 26 26 26 0 0 26 0 0 0 0 0 0 0 0 26 0 0 0 0 0 26 0 0 26 0 0
0 0 26 0 0 26 0 0 26 0 0 26 26 26 0 0 26 0 0 26 0 0 26 26 26 26 0 0 26 0 0 26 0 0 26 0 0 26 0 0
0 0 26 0 0 26 26 26 26 0 0 26 0 0 0 0 26 0 0 26 0 0 26 0 0 26 0 0 26 0 0 26 0 0 26 0 0 26 0 0
0 0 0 0 0 0 0 0 26 0 0 26 0 0 0 0 26 0 0 26 0 0 26 0 0 26 0 0 26 0 0 26 0 0 26 26 26 26 0 0
0 0 0 0 0 0 0 0 26 0 0 26 0 0 0 0 26 26 26 26 0 0 26 0 0 26 0 0 26 0 0 26 0 0 0 0 0 0 0 0
26 26 26 26 26 26 0 0 26 0 0 26 0 0 0 0 26 0 0 26 0 0 26 0 0 26 0 0 26 0 0 26 0 0 0 0 0 0 0 0
0 0 0 0 0 0 0 0 26 0 0 26 0 0 0 0 26 0 0 26 0 0 26 0 0 26 0 0 26 0 0 26 0 0 0 0 0 0 0 0
0 0 0 0 0 0 0 0 26 0 0 26 0 0 0 0 0 0 0 26 0 0 26 0 0 26 0 0 26 0 0 26 26 26 26 26 26 26 0 0
26 26 26 26 26 26 0 0 26 0 0 0 0 0 0 0 0 0 0 26 0 0 26 0 0 26 0 0 26 0 0 26 0 0 26 0 0 0 0 0
0 0 0 0 0 0 0 0 26 26 26 26 26 26 26 26 26 0 0 26 0 0 26 0 0 26 0 0 26 0 0 26 0 0 26 0 0 26 0 0
0 0 0 0 0 0 0 0 0 0 26 0 0 0 0 0 26 0 0 0 0 0 26 0 0 26 0 0 26 0 0 26 0 0 26 0 0 26 0 0
0 0 26 0 0 26 0 0 0 0 26 0 0 0 0 0 26 26 26 26 26 26 26 0 0 26 0 0 26 0 0 26 0 0 26 0 0 26 0 0
0 0 26 26 26 26 26 26 0 0 26 0 0 26 0 0 0 0 0 0 0 0 0 0 0 0 0 0 0 0 0 0 0 0 26 0 0 26 0 0
0 0 0 0 0 26 0 0 0 0 26 0 0 26 0 0 0 0 0 0 0 0 0 0 0 0 0 0 0 0 0 0 0 0 26 0 0 26 0 0
0 0 0 0 0 26 0 0 0 0 26 0 0 26 26 26 26 26 26 26 26 26 26 26 26 26 26 26 26 26 26 26 26 26 26 0 0 26 0 0
26 26 26 0 0 26 26 26 0 0 26 0 0 26 0 0 26 0 0 0 0 0 0 0 0 0 0 0 0 0 0 0 0 0 26 0 0 26 0 0
0 0 0 0 0 26 0 0 0 0 26 0 0 26 0 0 26 0 0 0 0 0 0 0 0 0 0 0 0 0 0 0 0 0 26 0 0 26 0 0
0 0 0 0 0 26 0 0 0 0 26 0 0 26 0 0 0 0 0 26 26 26 26 26 26 26 26 26 26 26 26 26 0 0 26 0 0 26 0 0
26 26 26 0 0 26 26 26 26 26 26 0 0 26 0 0 0 0 0 0 0 0 0 0 0 0 0 0 0 0 0 26 0 0 0 0 0 26 0 0
0 0 26 0 0 26 0 0 0 0 26 0 0 26 0 0 0 0 0 0 0 0 0 0 0 0 0 0 0 0 0 26 0 0 0 0 0 26 0 0
0 0 26 0 0 26 0 0 0 0 26 0 0 26 26 26 26 26 26 26 26 26 26 26 26 26 26 26 26 0 0 26 26 26 26 26 26 26 0 0
0 0 26 0 0 0 0 0 0 0 26 0 0 0 0 0 0 0 0 0 0 0 0 0 0 0 0 0 26 0 0 26 26 0 0 0 0 0 0 0
0 0 0 0 0 0 0 0 47 0 26 0 0 0 0 0 0 0 0 0 0 0 0 0 0 0 0 0 26 0 0 26 26 0 0 0 0 0 0 0
26 26 26 26 26 26 26 26 26 26 26 26 26 26 26 26 26 26 26 26 26 26 26 26 26 26 0 0 26 26 26 26 26 26 26 26 26 26 26 26
26 26 26 26 26 26 26 26 26 26 26 0 0 0 0 0 0 0 0 0 0 0 0 0 0 0 0 0 26 26 26 26 26 26 26 26 26 26 26 26
26 26 26 26 26 26 26 26 26 26 26 0 0 0 0 0 0 0 0 0 0 0 0 0 0 0 0 0 26 26 26 26 26 26 26 26 26 26 26 26
26 26 26 26 26 26 26 26 26 26 26 0 0 26 26 0 0 0 0 0 0 0 0 0 0 0 0 0 26 26 26 26 26 26 26 26 26 26 26 26
26 26 26 26 26 26 26 26 26 26 26 0 0 26 26 0 0 0 0 0 0 0 0 0 0 0 0 0 26 26 26 26 26 26 26 26 26 26 26 26
26 26 26 26 26 26 26 26 26 26 26 0 0 26 26 0 0 0 0 0 0 0 0 0 0 0 0 0 26 26 26 26 26 26 26 26 26 26 26 26
26 26 26 26 26 26 26 26 26 26 26 0 0 26 26 0 0 0 0 0 0 0 0 0 0 0 0 0 26 26 26 26 26 26 26 26 26 26 26 26
26 26 26 26 26 26 26 26 26 26 26 0 0 26 26 0 0 0 0 0 0 0 0 0 0 0 0 0 26 26 26 26 26 26 26 26 26 26 26 26
26 26 26 26 26 26 26 26 26 26 26 0 0 26 26 0 0 0 0 0 0 0 0 0 0 0 0 0 26 26 26 26 26 26 26 26 26 26 26 26
26 26 26 26 26 26 26 26 26 26 26 0 0 26 26 0 0 0 0 0 0 0 0 0 0 0 0 0 26 26 26 26 26 26 26 26 26 26 26 26
26 26 26 26 26 26 26 26 26 26 26 0 0 0 0 0 0 0 0 0 0 0 0 0 0 0 0 0 26 26 26 26 26 26 26 26 26 26 26 26
26 26 26 26 26 26 26 26 26 26 26 0 0 0 0 0 0 0 0 0 0 0 0 0 0 0 0 0 26 26 26 26 26 26 26 26 26 26 26 26
26 26 26 26 26 26 26 26 26 26 26 26 26 26 26 26 26 26 26 28 29 26 26 26 26 26 26 26 26 26 26 26 26 26 26 26 26 26 26 26
528.0 2016.0 1728.0 864.0 |
|
