17 12
1 1 1 1 1 1 1 1 1 1 1 1 1 1 1 1 1
1 0 0 0 0 0 0 0 0 0 0 0 0 0 0 0 1
1 0 0 0 0 0 0 0 0 0 0 0 0 0 0 0 1
1 0 0 0 0 0 0 0 0 0 0 0 0 0 0 0 1
1 0 0 0 0 0 0 0 0 0 0 0 0 0 0 0 1
1 0 0 0 0 0 0 0 0 0 0 0 0 0 0 0 1
1 0 0 26 26 0 0 0 0 0 0 0 0 0 0 0 1
1 0 0 26 26 0 0 0 0 0 0 0 0 0 0 0 1
1 0 0 26 26 0 0 0 0 0 0 0 0 0 0 0 1
1 0 0 26 26 0 0 0 0 0 0 0 0 0 0 0 1
1 0 0 26 26 0 0 0 0 0 0 0 0 0 0 0 1
1 1 1 1 1 1 1 28 29 1 1 1 1 1 1 1 1
480.0 56.0 672.0 104.0 96.0 296.0 |
|
