17 12
45 45 45 45 45 45 45 45 45 45 45 45 45 45 45 45 45
45 44 44 44 44 44 44 44 44 44 44 44 44 44 44 44 45
45 44 44 44 44 44 44 44 44 44 44 44 44 44 44 44 45
45 26 26 26 26 26 26 26 26 26 26 26 26 26 26 44 45
45 44 44 44 44 44 44 44 44 44 44 44 44 44 44 44 45
45 44 42 44 44 42 44 44 42 44 44 44 44 44 44 44 45
45 44 44 44 44 44 44 44 44 44 44 44 44 44 44 44 45
45 44 44 44 44 44 44 44 44 44 44 44 44 44 44 44 45
45 44 42 44 44 42 44 44 42 44 44 44 44 44 44 44 45
45 44 44 44 44 44 44 44 44 44 44 44 44 44 44 44 45
45 44 44 44 44 44 44 44 44 44 44 44 44 44 44 44 45
45 45 45 45 45 45 45 28 29 45 45 45 45 45 45 45 45
|
|
