17 12
1 1 1 1 1 1 1 1 1 1 1 1 1 1 1 1 1
1 17 17 17 17 17 17 17 17 17 17 17 17 17 17 17 1
1 17 17 17 17 17 17 17 17 17 17 17 17 17 17 17 1
1 26 26 26 26 26 26 26 26 26 26 26 26 26 26 17 1
1 17 17 17 17 17 17 17 17 17 17 17 17 17 17 17 1
1 17 17 17 17 17 17 17 17 17 17 17 17 17 17 17 1
1 17 26 17 17 26 17 17 26 17 17 17 17 17 17 17 1
1 17 17 17 17 17 17 17 17 17 17 17 17 17 17 17 1
1 17 17 17 17 17 17 17 17 17 17 17 17 17 17 17 1
1 17 26 17 17 26 17 17 26 17 17 17 17 17 17 17 1
1 17 17 17 17 17 17 17 17 17 17 17 17 17 17 17 1
1 1 1 1 1 1 1 28 29 1 1 1 1 1 1 1 1
|
|
