17 12
45 45 45 45 45 45 45 45 45 45 45 45 45 45 45 45 45
45 0 0 0 0 0 0 0 0 0 0 0 0 0 0 0 45
45 0 0 0 0 0 0 0 0 0 0 0 0 0 0 0 45
45 0 0 0 0 0 0 0 0 0 0 0 0 0 0 0 45
45 0 0 0 0 0 0 0 0 0 0 0 0 0 0 0 45
45 0 0 0 0 0 0 0 0 0 0 0 0 0 0 0 45
45 0 0 26 26 0 0 0 0 0 0 0 0 0 0 0 45
45 0 0 26 26 0 0 0 0 0 0 0 0 0 0 0 45
45 0 0 26 26 0 0 0 0 0 0 0 0 0 0 0 45
45 0 0 26 26 0 0 0 0 0 0 0 0 0 0 0 45
45 0 0 26 26 0 0 0 0 0 0 0 0 0 0 0 45
45 45 45 45 45 45 45 28 29 45 45 45 45 45 45 45 45
|
|
