17 20
16 16 16 16 16 16 16 16 16 16 16 16 16 16 16 16 16
16 0 0 0 0 0 0 0 0 0 0 0 0 0 0 0 16
16 0 0 0 0 0 0 0 0 0 0 0 0 0 0 0 16
16 0 0 0 0 0 0 0 0 0 0 0 0 0 0 0 16
16 0 0 0 0 0 0 0 0 0 0 0 0 0 0 0 16
16 0 0 0 0 0 0 0 0 0 0 0 0 0 0 0 16
16 0 0 0 0 0 0 0 0 0 0 0 0 0 0 0 16
16 0 0 0 0 0 0 0 0 0 0 0 0 0 0 0 16
16 0 0 0 0 0 0 0 0 0 0 0 0 0 0 0 16
16 0 0 0 0 0 0 0 0 0 0 0 0 0 0 0 16
16 0 0 0 0 0 0 0 0 0 0 0 0 0 0 0 16
16 0 0 0 0 0 0 0 0 0 0 0 0 0 0 0 16
16 0 0 0 0 0 0 0 0 0 0 0 0 0 0 0 16
16 0 0 0 0 0 0 0 0 0 0 0 0 0 0 0 16
16 0 0 0 0 0 0 0 0 0 0 0 0 0 0 0 16
16 16 16 16 16 16 16 0 0 0 16 16 16 16 16 16 16
0 0 0 0 0 0 0 0 2 0 0 0 0 0 0 0 0
0 0 0 0 0 0 0 0 2 0 0 0 0 0 0 0 0
0 0 0 0 0 0 0 0 2 0 0 0 0 0 0 0 0
0 0 0 0 0 0 0 0 2 0 0 0 0 0 0 0 0
|
|
