45 35
0 0 0 0 0 0 0 0 0 0 0 0 0 0 0 0 0 0 0 17 17 17 17 17 17 0 0 0 0 0 0 0 0 0 0 0 0 10 12 12 11 0 0 0 0
0 10 12 12 11 0 4 4 4 0 0 0 0 0 0 0 0 0 0 17 17 17 17 17 17 0 0 0 4 4 4 0 0 10 11 0 0 20 15 15 15 0 0 0 0
0 13 15 15 13 4 4 4 4 4 0 10 12 12 12 12 12 11 0 0 0 0 0 0 0 0 0 4 4 4 4 4 0 15 15 10 12 12 12 12 12 12 11 0 0
10 12 12 12 12 11 2 1 3 0 0 0 13 13 13 13 13 0 14 10 12 12 12 12 11 0 0 0 2 1 3 0 0 15 15 15 15 15 15 15 15 15 15 0 0
0 13 13 13 13 0 0 1 0 0 0 0 13 15 15 13 13 0 0 0 13 13 13 13 0 0 0 14 0 1 0 0 5 15 15 13 13 13 13 13 13 13 13 5 0
5 13 15 6 13 5 17 1 17 0 0 5 13 15 15 6 13 5 0 5 13 15 6 13 5 0 0 0 0 1 0 14 5 15 15 13 13 13 6 6 13 13 13 5 0
5 5 5 7 5 5 9 17 17 14 0 5 5 5 5 7 5 5 9 5 5 5 7 5 5 9 0 0 17 1 17 0 5 5 5 5 5 5 7 7 5 5 5 5 0
17 0 0 7 0 0 8 19 0 0 0 0 0 0 0 7 0 0 8 0 0 0 7 0 0 8 0 0 17 17 17 0 0 0 0 0 19 17 7 7 17 0 0 0 0
17 0 18 18 18 18 18 18 18 18 18 18 18 18 18 18 18 18 18 18 18 18 7 7 0 0 0 0 0 0 0 0 0 14 0 0 0 0 7 7 0 4 4 4 0
14 0 18 18 18 18 18 18 18 18 18 18 18 18 18 18 18 18 18 18 18 18 7 7 0 0 0 0 17 17 17 17 17 0 0 0 0 0 7 7 4 4 4 4 4
17 0 7 7 0 0 0 0 0 0 0 0 4 4 4 0 0 0 0 0 0 0 7 7 0 0 0 0 17 5 5 5 17 0 0 0 0 0 7 7 0 2 1 3 0
17 0 7 7 0 10 12 12 12 11 0 4 4 4 4 4 10 12 12 12 11 0 7 7 0 0 14 0 17 17 17 17 17 0 0 0 0 9 7 7 0 0 1 0 14
17 0 7 7 0 0 13 13 13 0 0 0 2 1 3 0 0 13 13 13 0 0 7 7 19 0 0 0 0 0 0 0 0 0 0 0 0 8 7 7 0 17 1 17 0
17 0 7 7 0 5 15 6 15 5 17 17 0 1 0 0 5 15 6 15 5 0 7 23 18 18 18 18 18 18 18 18 18 18 18 18 18 18 18 18 0 17 17 17 0
17 0 7 7 9 5 5 7 5 5 17 17 0 1 0 9 5 5 7 5 5 0 7 7 18 18 18 18 18 18 18 18 18 18 18 18 18 18 18 18 0 0 0 0 4
17 0 7 7 8 0 0 7 0 0 0 0 14 0 0 8 0 0 7 0 0 0 7 7 0 0 0 7 7 0 0 0 0 0 0 0 0 0 0 0 0 0 0 4 4
17 0 7 7 18 18 18 18 18 18 18 18 18 18 18 18 18 18 18 18 18 18 7 7 0 16 0 7 7 0 0 0 12 12 12 12 12 12 12 12 12 12 4 4 4
17 0 7 7 18 18 18 18 18 18 18 18 18 18 18 18 18 18 18 18 18 18 7 7 0 14 0 7 7 0 0 0 13 13 13 13 13 13 13 13 13 13 0 2 1
0 0 0 0 0 0 0 0 0 0 0 0 0 0 0 0 0 0 0 0 0 0 7 7 0 0 0 7 7 0 14 0 13 15 15 13 15 15 13 15 15 13 0 0 1
0 0 10 12 12 12 12 12 12 12 12 12 12 12 12 12 12 12 12 11 0 0 7 7 0 5 0 7 7 0 0 0 13 15 15 13 13 13 13 15 15 13 0 14 1
0 0 0 13 15 15 13 15 15 13 15 15 13 15 15 13 15 15 13 0 0 0 7 7 0 5 0 7 7 0 17 5 13 13 13 13 6 6 13 13 13 13 5 0 1
0 14 0 13 13 13 13 13 13 13 13 13 13 13 13 13 13 13 13 0 0 0 7 7 0 5 0 7 7 0 17 5 5 5 5 5 7 7 5 5 5 5 5 17 1
0 0 10 12 12 12 12 12 12 12 12 12 12 12 12 12 12 12 12 11 0 0 7 7 0 0 0 7 7 0 0 0 0 0 0 19 7 7 9 0 0 0 0 17 17
0 0 0 13 15 15 13 15 15 13 15 15 13 15 15 13 15 15 13 0 0 0 7 7 18 18 18 18 18 18 18 18 18 18 18 18 7 7 8 0 0 0 0 0 0
0 0 5 13 13 6 13 13 6 13 13 6 13 13 6 13 13 6 13 5 0 0 7 7 18 18 18 18 18 18 18 18 18 18 18 18 7 7 0 0 0 14 0 0 0
0 0 5 5 5 7 5 5 7 5 5 7 5 5 7 5 5 7 5 5 9 0 7 7 0 0 0 0 0 0 0 0 0 0 0 0 0 0 0 0 0 0 0 0 0
0 0 0 17 19 7 17 19 7 17 19 7 17 19 7 17 19 7 17 0 8 0 7 7 0 0 10 12 12 12 11 10 12 12 12 11 10 12 12 12 11 0 0 0 0
0 18 18 18 18 18 18 18 18 18 18 18 18 18 18 18 18 18 18 18 18 18 7 7 0 0 0 13 13 13 0 0 13 13 13 0 0 13 13 13 0 0 0 14 0
0 18 18 18 18 18 18 18 18 18 18 18 18 18 18 18 18 18 18 18 18 18 7 7 0 0 5 13 6 13 5 5 13 6 13 5 5 13 6 13 5 0 0 0 0
0 0 0 0 0 0 0 0 0 0 0 0 0 0 0 0 0 0 0 0 0 0 7 7 0 9 5 5 7 5 5 5 5 7 5 5 5 5 7 5 5 0 0 0 0
0 0 4 4 4 0 0 0 0 4 4 4 0 0 0 0 4 4 4 0 0 0 7 7 0 8 0 17 7 0 0 0 17 7 0 0 0 17 7 0 0 0 0 17 17
0 4 4 4 4 4 0 0 4 4 4 4 4 0 0 4 4 4 4 4 0 0 7 7 18 18 18 18 18 18 18 18 18 18 18 18 18 18 18 18 18 18 0 17 5
14 0 2 1 3 0 0 0 0 2 1 3 0 0 14 0 2 1 3 0 0 0 7 18 18 18 18 18 18 18 18 18 18 18 18 18 18 18 18 18 18 18 0 17 5
0 0 17 1 17 0 0 0 0 17 1 17 0 0 0 0 17 1 17 0 0 0 0 0 0 0 0 0 0 0 0 0 0 0 0 0 0 0 0 0 0 0 0 17 5
0 0 17 17 17 0 0 0 0 17 17 17 0 0 0 0 17 17 17 0 0 0 0 0 0 0 0 0 0 0 0 0 0 0 0 0 0 0 0 0 0 0 0 17 17
1200.0 576.0 1680.0 1104.0 1728.0 1152.0 1824.0 432.0 960.0 336.0 1104.0 1008.0 96.0 384.0 1632.0 1488.0 336.0 1304.0 672.0 1392.0 48.0 776.0 1008.0 872.0 |
1016.0 480.0 1016.0 576.0 1008.0 720.0 1488.0 576.0 1440.0 576.0 1536.0 576.0 |
