40 30
0 0 0 0 0 0 0 0 0 0 0 0 0 0 0 0 0 0 0 18 19 0 0 0 0 0 0 0 0 0 0 0 0 0 0 0 0 0 0 0
0 0 0 0 0 8 8 8 0 0 0 0 0 0 0 0 0 0 0 16 16 0 0 0 0 0 0 0 0 0 0 8 8 8 0 0 0 0 0 0
0 8 8 8 0 8 8 8 0 0 0 0 0 0 0 0 18 17 17 16 16 17 17 19 0 0 0 0 0 0 0 8 8 8 0 0 0 0 0 0
0 8 8 8 0 0 7 0 0 0 0 0 0 0 0 0 16 16 16 16 16 16 16 16 0 0 0 0 0 0 0 0 7 0 0 0 0 0 0 0
0 0 7 0 0 0 12 0 0 0 9 9 9 0 0 14 16 22 16 20 20 20 16 16 14 0 0 0 0 0 0 0 7 0 0 0 0 0 0 0
0 0 4 0 0 0 0 0 0 0 9 9 9 0 0 14 14 14 14 14 14 14 14 14 14 0 0 0 13 0 0 0 12 0 0 0 0 0 0 0
0 0 12 0 0 0 0 0 0 0 0 0 0 0 0 0 0 2 0 0 0 0 0 0 0 0 13 0 0 0 0 0 0 0 0 0 0 0 0 0
0 0 0 18 17 17 17 19 0 8 8 8 0 0 0 0 0 2 0 0 0 0 0 0 0 0 0 0 0 13 0 0 0 0 0 0 0 0 0 0
0 0 0 16 16 16 16 16 0 8 8 8 0 0 0 0 0 2 0 0 0 0 0 0 0 0 0 0 0 0 0 0 0 0 0 0 0 0 0 0
0 0 0 16 21 22 21 16 0 0 7 0 0 0 8 8 8 2 0 10 10 10 0 0 0 0 17 17 17 17 17 17 17 17 17 0 0 0 0 0
0 0 0 14 14 14 14 14 0 0 12 0 0 0 8 8 8 2 0 10 10 10 0 0 0 0 16 16 16 16 16 16 16 16 16 0 0 0 0 0
0 0 0 14 14 14 14 14 0 0 0 0 0 0 0 7 0 2 0 0 0 0 0 0 0 0 16 20 16 16 20 16 16 20 16 0 0 0 0 0
0 0 0 0 0 2 0 0 0 0 3 0 0 0 0 7 6 2 0 0 0 0 0 0 0 14 16 22 16 16 22 16 16 22 16 14 0 0 0 0
0 0 0 0 0 2 0 0 0 0 0 0 0 0 0 12 0 2 0 0 0 0 0 0 0 14 14 14 14 14 14 14 14 14 14 14 0 0 0 0
0 0 0 0 0 2 0 0 0 0 0 0 0 0 0 0 0 2 0 0 0 0 0 0 0 14 14 14 14 14 14 14 14 14 14 14 0 0 0 0
2 2 2 2 2 2 2 2 2 2 2 2 2 2 2 2 2 2 2 2 2 2 2 2 2 2 2 2 2 2 2 2 2 2 2 2 2 2 2 2
0 0 0 0 0 0 0 0 0 0 0 0 0 0 2 0 0 0 0 0 0 0 0 0 0 0 0 0 0 0 0 0 0 0 0 0 0 0 0 0
0 8 8 8 0 0 0 0 18 17 17 17 19 0 2 0 18 17 17 17 19 0 0 0 0 0 8 8 8 0 0 0 0 0 0 0 0 0 0 0
0 8 8 8 0 0 0 0 16 16 16 16 16 0 2 0 16 16 16 16 16 0 0 0 0 8 8 8 8 8 0 17 17 17 0 0 0 0 0 0
0 0 7 0 0 0 15 14 16 20 16 16 16 14 2 14 16 16 16 21 16 14 0 0 0 0 0 7 0 0 0 16 16 16 0 0 0 0 0 0
0 0 12 0 0 0 0 14 16 16 16 22 16 14 2 14 16 22 16 16 16 14 0 0 0 0 5 7 0 0 0 16 22 16 0 0 0 0 0 0
0 0 0 0 0 0 0 14 14 14 14 14 14 14 2 14 14 14 14 14 14 14 0 0 0 0 0 7 0 0 0 14 14 14 0 0 8 8 8 0
0 0 0 8 8 8 0 14 14 14 14 14 14 14 2 14 14 14 14 14 14 14 0 0 0 0 0 12 0 0 0 0 2 0 0 0 8 8 8 0
0 0 8 8 8 8 8 0 0 8 8 8 15 0 2 0 0 0 0 0 0 0 3 0 0 0 0 0 0 0 0 0 2 0 0 0 0 7 0 0
0 0 0 0 7 0 0 0 0 8 8 8 0 0 2 2 2 2 2 2 2 2 2 2 2 2 2 2 2 2 2 2 2 0 0 0 0 7 0 0
0 0 0 0 12 0 0 0 0 0 7 0 0 0 0 0 0 10 10 10 0 0 0 0 0 0 0 0 0 0 0 0 0 0 0 0 0 12 0 0
0 0 0 0 0 0 0 15 0 0 12 0 0 0 0 0 0 10 10 10 0 0 0 0 0 0 8 8 8 0 0 0 0 0 0 0 0 0 0 0
0 0 0 0 0 0 0 0 0 0 0 0 0 0 0 0 0 0 0 0 0 0 0 0 0 0 8 8 8 0 0 0 0 0 0 0 0 0 0 0
0 0 0 0 0 0 0 0 0 0 0 0 0 0 0 0 0 0 0 0 0 0 0 0 0 0 0 7 0 0 0 0 0 0 0 0 0 0 0 0
0 0 0 0 0 0 0 0 0 0 0 0 0 0 0 0 0 0 0 0 0 0 0 0 0 0 0 12 0 0 0 0 0 0 0 0 0 0 0 0
192.0 488.0 624.0 192.0 1488.0 1016.0 864.0 968.0 864.0 200.0 480.0 1016.0 1488.0 632.0 1344.0 536.0 192.0 672.0 |
768.0 672.0 240.0 480.0 |
