40 30
40 30
0 0 0 0 0 0 0 0 0 0 0 0 0 0 0 0 0 0 9 11 11 10 0 0 0 0 0 0 0 4 4 4 4 0 0 0 0 0 0 0
0 0 0 0 0 0 0 0 0 0 0 0 0 0 0 0 0 0 0 12 12 0 0 0 0 0 0 0 4 4 4 4 4 4 0 0 0 0 0 0
0 0 0 0 0 0 0 0 0 4 0 0 0 0 0 9 11 11 11 12 12 11 11 11 10 0 0 4 4 4 4 4 4 4 4 0 0 0 0 0
0 0 0 0 0 0 0 0 4 4 4 0 0 0 0 0 12 12 12 12 12 12 12 12 0 0 0 0 0 2 1 1 3 0 0 0 0 0 0 0
0 13 0 0 9 11 10 0 2 1 3 0 0 0 0 4 12 5 12 14 14 14 12 12 4 0 0 0 0 0 1 1 0 0 0 0 0 0 0 0
0 0 0 9 11 11 11 10 0 1 0 0 0 0 0 4 4 0 15 4 4 4 4 4 4 0 0 0 0 0 1 1 0 0 0 0 0 0 0 0
0 0 9 11 11 11 11 11 10 0 0 0 0 0 0 0 0 6 0 0 0 0 0 0 0 0 0 0 0 0 0 0 0 0 0 0 0 0 0 0
0 0 0 12 12 12 12 12 0 0 0 0 0 0 0 0 0 6 0 0 0 0 0 0 0 0 0 0 0 0 0 0 0 0 0 0 0 0 0 0
0 0 0 12 12 12 14 12 0 0 0 0 0 0 0 0 0 6 0 0 0 0 0 0 0 0 9 11 11 11 11 11 11 11 10 0 0 0 0 0
0 0 0 12 5 12 12 12 0 0 0 0 0 0 0 0 0 6 0 0 0 0 0 0 0 9 11 11 11 11 11 11 11 11 11 10 0 0 0 0
0 0 0 15 0 17 0 0 0 0 0 0 0 0 0 0 0 6 0 0 0 0 0 0 0 0 12 12 12 12 12 12 12 12 12 0 0 0 0 0
0 0 0 0 0 0 0 0 0 0 0 0 0 0 0 0 0 6 0 0 0 0 0 0 0 0 12 14 12 12 14 12 12 14 12 0 0 0 0 0
0 0 0 0 0 0 0 0 0 0 0 0 0 0 0 0 0 6 0 0 0 0 0 0 0 4 12 5 12 12 5 12 12 5 12 4 0 0 0 0
0 0 0 0 0 0 0 0 0 0 0 0 0 0 0 0 0 6 0 13 0 0 0 0 0 4 4 6 4 4 6 4 4 6 4 4 0 0 0 0
0 0 0 0 0 0 0 0 0 0 0 0 0 0 0 0 0 6 0 0 0 0 0 0 0 0 0 6 17 0 6 17 0 6 17 0 0 0 0 0
16 16 16 16 16 16 16 16 16 16 16 16 16 16 16 16 16 16 16 16 16 16 16 16 16 16 16 16 16 16 16 16 16 16 16 16 16 16 16 16
0 0 0 0 0 0 0 0 9 11 11 11 10 0 6 0 9 11 11 11 10 0 0 0 0 0 0 0 0 0 0 0 0 0 0 0 0 0 0 0
0 4 4 4 0 0 0 9 11 11 11 11 11 10 6 9 11 11 11 11 11 10 0 0 0 0 0 0 0 0 0 9 11 10 0 0 0 0 0 0
0 4 4 4 0 0 0 0 12 12 12 12 12 0 6 0 12 12 12 12 12 0 0 0 0 0 13 0 0 0 9 11 11 11 10 0 0 0 0 0
0 2 1 3 0 0 15 4 12 14 12 12 12 4 6 4 12 12 12 14 12 4 0 0 0 0 0 0 0 0 0 12 12 12 0 0 0 0 0 0
0 0 1 0 0 0 0 4 12 12 12 5 12 4 6 4 12 5 12 12 12 4 0 0 0 0 0 0 0 0 4 12 5 12 4 0 0 0 0 0
0 0 0 0 0 0 0 4 4 4 0 6 4 4 6 4 4 6 0 4 4 4 0 0 0 0 0 0 0 0 4 4 6 4 4 0 0 0 0 0
0 0 0 4 4 4 0 4 4 4 0 6 4 4 6 4 4 6 0 4 4 4 0 0 0 0 0 0 0 0 0 0 6 17 0 0 0 0 0 0
0 0 4 4 4 4 4 0 0 0 0 16 16 16 6 0 0 6 0 0 0 0 0 0 0 0 0 0 0 0 0 0 6 0 0 0 0 0 0 0
0 0 0 2 1 3 0 0 0 0 0 0 0 0 6 16 16 16 16 16 16 16 16 16 16 16 16 16 16 16 16 16 6 0 0 0 0 0 0 0
0 0 0 0 1 0 0 0 0 0 0 0 0 0 0 0 0 0 0 0 0 0 0 0 0 0 0 0 0 0 0 0 0 0 0 0 0 0 0 0
0 0 0 0 0 0 0 15 0 0 0 0 0 0 13 0 0 0 0 0 0 0 0 0 0 0 4 4 4 0 0 0 0 0 0 0 0 0 0 0
0 0 0 0 0 0 0 0 0 0 0 0 0 0 0 0 0 0 0 0 0 0 0 0 0 4 4 4 4 4 0 0 0 0 0 0 0 13 0 0
0 0 0 0 0 0 0 0 0 0 0 0 0 0 0 0 0 0 0 0 0 0 0 0 0 0 2 1 3 0 0 0 0 0 0 0 0 0 0 0
0 0 0 0 0 0 0 0 0 0 0 0 0 0 0 0 0 0 0 0 0 0 0 0 0 0 0 1 0 0 0 0 0 0 0 0 0 0 0 0
288.0 536.0 624.0 192.0 1440.0 1064.0 816.0 1016.0 768.0 296.0 432.0 1112.0 1104.0 440.0 1104.0 584.0 |
768.0 672.0 144.0 576.0 |
