40 30
0 0 0 0 0 0 0 0 0 0 4 4 0 0 0 0 0 0 9 11 11 10 0 0 0 0 0 0 0 0 0 0 0 0 0 0 0 0 0 0
0 0 0 0 0 0 0 0 0 4 4 4 4 0 0 0 0 0 12 12 12 12 0 0 0 0 0 4 4 4 0 0 0 0 0 0 0 0 0 0
0 0 0 0 0 0 0 0 4 4 4 4 4 4 0 9 11 11 11 11 11 11 11 11 10 0 4 4 4 4 4 0 0 0 0 0 4 0 0 0
0 0 0 0 9 11 10 0 0 2 1 1 3 0 0 0 12 12 12 12 12 12 12 12 0 0 0 2 1 3 0 0 0 0 0 4 4 4 0 0
0 0 0 9 11 11 11 10 0 0 1 1 0 0 0 4 12 5 12 14 14 14 12 12 4 0 0 0 1 0 0 0 0 0 4 4 4 4 4 0
0 0 9 11 11 11 11 11 10 0 1 1 0 0 0 4 4 6 15 4 4 4 4 4 4 0 0 0 1 0 0 0 0 0 0 2 1 3 0 0
0 0 0 12 12 12 12 12 0 0 0 0 0 0 0 17 17 6 0 0 0 0 0 0 0 0 0 0 0 0 0 0 0 0 0 0 1 0 0 0
0 0 0 12 14 12 14 12 0 0 0 0 0 0 0 0 0 6 0 0 0 0 0 0 0 0 9 11 11 11 11 11 11 11 10 0 0 0 0 0
0 0 0 12 12 5 12 12 0 0 0 0 0 13 0 0 0 6 0 0 0 0 0 0 0 9 11 11 11 11 11 11 11 11 11 10 0 0 0 0
0 0 0 4 4 6 4 4 0 0 0 4 4 4 4 0 0 6 0 0 4 4 0 0 0 0 12 12 12 12 12 12 12 12 12 0 0 0 0 0
0 0 0 4 4 6 4 4 0 0 0 4 4 4 4 0 0 6 0 0 0 15 0 0 4 4 12 12 14 12 14 12 14 12 12 4 4 0 0 0
0 13 0 0 0 6 0 0 0 0 0 0 0 0 0 0 0 6 0 0 0 0 0 0 4 4 12 5 12 5 12 5 12 5 12 4 4 0 0 0
0 0 0 0 0 6 8 0 0 0 0 0 0 0 0 8 0 6 0 0 0 0 0 0 4 4 4 6 4 6 4 6 4 6 4 4 4 0 0 0
0 0 0 0 0 6 7 0 0 0 0 0 0 0 0 7 0 6 0 0 0 0 17 0 4 4 4 6 4 6 4 6 4 6 4 4 4 17 17 17
16 16 16 16 16 16 16 16 16 16 16 16 16 16 16 16 16 16 16 16 16 16 16 16 16 16 16 16 16 16 16 16 16 16 16 16 16 16 16 16
0 0 0 0 0 0 0 0 0 0 0 0 0 0 6 0 0 0 0 0 0 0 0 0 0 0 0 0 0 0 0 0 0 0 0 0 0 0 0 0
0 0 0 0 0 0 0 9 11 11 11 10 0 0 6 0 0 9 11 11 11 10 0 0 0 0 0 0 0 0 0 0 0 0 0 0 0 13 0 0
0 0 0 0 0 0 9 11 11 11 11 11 10 0 6 0 9 11 11 11 11 11 10 0 0 0 0 0 0 0 9 11 11 11 10 0 0 0 0 0
0 0 0 0 0 0 0 12 12 12 12 12 0 0 6 0 0 12 12 12 12 12 0 0 0 0 0 0 0 0 0 12 12 12 0 0 0 0 0 0
0 0 0 0 0 0 4 12 14 12 12 12 4 0 6 0 4 12 12 12 14 12 4 0 0 0 0 0 0 0 4 12 5 12 4 0 0 0 0 0
0 0 4 0 0 0 4 12 12 12 5 12 4 0 6 0 4 12 5 12 12 12 4 0 0 0 0 0 0 0 4 4 6 4 4 0 0 0 0 0
0 4 4 4 0 0 4 4 4 15 6 4 4 0 6 8 4 4 6 15 4 4 4 0 0 0 0 0 0 0 0 17 6 0 0 0 0 0 15 0
4 4 4 4 4 0 0 0 17 0 16 16 16 16 6 7 0 0 6 0 17 0 0 0 0 0 0 0 0 0 0 0 6 0 0 0 0 15 0 0
0 2 1 3 0 0 17 0 0 0 0 0 0 0 6 16 16 16 16 16 16 16 16 16 16 16 16 16 16 16 16 16 16 0 0 0 0 0 13 0
0 0 1 0 0 0 0 0 0 0 0 0 0 0 0 0 0 0 0 0 0 0 0 0 0 0 0 0 0 0 0 0 0 0 0 0 0 0 0 0
0 0 1 0 0 0 0 0 0 0 0 0 0 0 0 0 0 0 0 0 0 0 0 0 0 0 0 0 0 0 0 0 0 0 0 0 0 0 0 0
0 0 1 0 0 0 0 0 0 0 0 0 0 0 0 0 0 0 0 0 0 0 0 0 0 0 0 0 0 0 0 0 0 0 0 0 0 0 0 0
0 0 0 0 0 0 0 0 0 0 0 0 0 0 0 0 0 0 0 0 0 0 0 0 0 0 0 0 0 0 0 0 0 0 0 0 0 0 0 0
0 0 0 0 0 0 0 0 0 0 0 0 0 0 0 0 0 0 0 0 0 0 0 0 0 0 0 0 0 0 0 0 0 0 0 0 0 0 0 0
0 0 0 0 0 0 0 0 0 0 0 0 0 0 0 0 0 0 0 0 0 0 0 0 0 0 0 0 0 0 0 0 0 0 0 0 0 0 0 0
|
|
