17 17
16 16 16 16 16 16 16 16 16 16 16 16 16 16 16 16 16
16 14 14 14 14 14 14 14 14 14 14 14 14 14 14 14 16
16 14 14 14 14 14 14 14 14 14 14 14 14 14 14 14 16
16 14 14 14 14 14 14 14 14 14 14 14 14 14 14 14 16
16 14 14 14 14 14 14 14 14 14 14 14 14 14 14 14 16
16 14 14 14 14 14 14 14 14 14 14 14 14 14 14 14 16
16 14 14 14 14 14 14 14 14 14 14 14 14 14 14 14 16
16 14 14 14 14 14 14 14 14 14 14 14 14 14 14 14 16
16 14 14 14 14 14 14 14 14 14 14 14 14 14 14 14 16
16 14 14 14 14 14 14 14 14 14 14 14 14 14 14 14 16
16 14 14 14 14 14 14 14 14 14 14 14 14 14 14 14 16
16 14 14 14 14 14 14 14 14 14 14 14 14 14 14 14 16
16 14 14 14 14 14 14 14 14 14 14 14 14 14 14 14 16
16 14 14 14 16 16 16 14 14 14 16 16 16 14 14 14 16
16 14 14 14 16 2 2 14 14 14 0 0 16 14 10 14 16
16 14 14 14 16 2 2 14 14 14 0 0 16 14 10 14 16
16 16 16 16 16 16 16 16 16 16 16 16 16 16 16 16 16
|
|
